DDDDXXDDDDDDDDDDDDDDDDDDDDDD
XXDDXXDDXXXXXXXXXXXXXXXXXDXX
DDDXXDDDDDDDXXDDDDDDXXDXDDDD
XXDDDXDDXXDDXXDDXXDDDDDDXXDD
DDDDXDDDDDDDXXDDDDDDXXDDDDDD
DDDDDDDDDDXXXXXDDDDXXXXDXXDX
XXXXXXXXDXXDDDXXDXDXDXXXXXDD
DDDDDDDDDXXDXXXDDXXXDXXXXXXX
DDDDDDDDDDDDDDDXXXXXDXXXXXXX
DDDDDDDDDDDDDDDDDDDDDDDDDDDD
DDDDDDDDDDDDDDDDDDDDDDDDDDDD
DDDDDDDDDDDDDDDDDDDDDDDDDDDD
DXDDXDXDXDXDXDDXDXDXXDXDXDXD
DXXXDDXXDDXXDDXDDXDDXDDXDDXD