DDDDXXDDDDDDDDDDDDDDDDDDDDDD
XXDDXXDDXXXXXXXXXXXXXXXXXDXX
DDDXXDDDDDDDXXDDDDDDXXDXDDDD
XXDDDXDDXXDDXXDDXXDDDDDDXXDD
DDDDXDDDDDDDXXDDDDDDXXDDDDDD
DDDDDDDDDDXXXDDDDDDXXXXDXXDX
XXXXXXXXDXXDDDXXDXDDDXXXXXDD