DDDDDDDDDDDDDXDXDXXXDDDXD
XXXDDXXXXXXDDXDXDXXXDDDDD
DDXXDDDDDDDDXXDXDDDDDXXXX
XDDXXXDDDXXXDDDDXDXDXXXXD
DDDDDDDXDXDDXDXDXDXDDDDDD
DDXXDDXXDDDXXDXDXXXDXDXXD
DDDDDDDDDDXXDDXDXDDDXXDXX
DXDXXDDXDXXXXDXDXDXDDDDDX
DDDDDDDDDDDDDDXDXDXXXDDDD
XXXXDDDXXXDDDXXXXDXDDDDDX
DDDDDDXXXXDDDDDDDDDXXXDXX
DDXXXXXXXXXDXXXXXDDDDDDDD
XXDDDDDDDDDDXXDDXXXDDXDXD
DDXXXXXXXXXXXXDDDDDDDXXDD
DDDDDDDDDDDXXXDDXXXXXDDDD
XXXXXXXDDXXDXDDDXXDDDXXDX
DDDDDDDDDXXDXDDDXXDDDDDDD
XXXXXXXDDXXDXDDDXXDXXXDDD
DDDDDDDDDDDDDDDDDDDDDXDDD
DXXXXXXDDXXXXXXXXXDDXXXDX