DDDDDDDDDXXDXXXDDXXXDXXXXXXX
DDDDDDDDDDDDDDDDXXXXDXXXXXXX
DDDDDDDDDDDDDDDDDDDDDDDDDDDD
DDDDDDDDDDDDDDDDDDDDDDDDDDDD
DDDDDDDDDDDDDDDDDDDDDDDDDDDD
DXDDXDXDXDXDXDDXDXDXXDXDXDXD
DXXXDDXXDDXXDDXDDXDDXDDXDDXD
DDDDXXDDDDDDDDDDDDDDDDDDDDDD
XXDDXXDDXXXXXXXXXXXXXXXXXDXX
DDDXXDDDDDDDXXDDDDDDXXDXDDDD
XXDDDXDDXXDDXXDDXXDDDDDDXXDD
DDDDXDDDDDDDXXDDDDDDXXDDDDDD
DDDDDDDDDDXXXXXDDDDXXXXDXXDX
XXXXXXXXDXXDDDDDDXDDDXXXXXDD