DDDDDDDDDDDDDXDXDDDDDDDXD
XXXDDXXXXXXDDXDXDXXXDDDDD
DDXXDDDDDDDDXXDDXDDDDDXXX
XDDXXXDDDXXXDDDDXDXDXXXXD
DDDDDDDXDXDDXDXDXDXDDDDDD
DDXXDDXXDDDXXDXDXXXDXDXXD
DDDDDDDDDDXXDDXDXDDDXXDXX
DXDXXDDXDXXXXDXDXDXDDDDDX
DDDDDDDDDDDDDDXDXDXXXDDDD
XXXXDXDXXXDDDXXXXDXDDDDDX
DDDDDDXXDXDDDDXDDDDXXXDXX
DDXXXXXXDXXDXXXXXDDDDDDDD
XDDDDDDDDDDDXXDDXXXDDXDXD
DDXXXXXXXXXXXXDDDDDDDXXDD
DDDDDDDDDDDXXXDDXXXXXDDDD
XDXXXXXDDXXDXDDDXXDDDXXDX
DDDDDDDXDXXDXDXDXXDDDDDDD
XXXDXXXDDXXDXDDDXXDXXXDXD
DDDDDDDDDDDDDDXDDDDDDXDDD
DXXXXXXDDXXXXXXXXXDDXXXDX